{
  "level": [
    "w...............................................................",
    "................................................................",
    "................................................................",
    "................................................................",
    "................................................................",
    "................................................................",
    "................................................................",
    "................................................................",
    "................................................................",
    "................................................................",
    ".....^^^^^^.....................................................",
    "................................................................",
    "................................................................",
    "................................................................",
    "................................................................",
    "................................................................",
    "................................................................",
    "................................................................",
    "................................................................",
    "................................................................",
    "................................................................",
    "................................................................",
    "................................................................",
    "................................................................",
    "................................................................",
    "........................====....................................",
    "........................=RR=..............wwww..................",
    "........................=RR=..............wwwww.................",
    "........................=RR=...............wwwww................",
    "........................=RR=...............wwwww................",
    "........................=RR=...............wwwww................",
    "........................=RR=...............wwwww................",
    "........................=RR=.................wwww...............",
    "........................=RR=.................wwww...............",
    "........................====....................................",
    "................................................................",
    "................................................................",
    "................................................................",
    "................................................................",
    "................................................................",
    "................................................................",
    "................................................................",
    "................................................................",
    "................................................................",
    "................................................................",
    "................................................................",
    "................................................................",
    "................................................................",
    "................................................................",
    "................................................................",
    "................................................................",
    "................................................................",
    "................................................................",
    "................................................................",
    "................................................................",
    "................................................................",
    "................................................................",
    "................................................................",
    "................................................................",
    "................................................................",
    "................................................................",
    "................................................................",
    "................................................................",
    "................................................................"
  ]
}
